25 25
VVVVVVVVVVVVVVVVVVVVVVVVV
VVVVVVVVVVVVVVVVVVVVVVVVV
VVVHVVVVVVVVVVVVVVVVVVVVV
VVVVVVVVVVVVVVVVVVVVVVVVV
VVPPPPPVCVVVVVVVVVVVVVVVV
VVVVVVVVCVVVVVVVRVVVVVVVV
VVVVVVVVCVVVVVVVRVVVVVVVV
VVVPPPPPPPVVVVVVRVVVVVVVV
VVVVVVVVVVPPPPPPRVVVVVVVV
VVVVVVVVVVVVVVVVRVVVVVVVV
VVVVVVVVVVVVRVVVBVVVVVVVV
PPPVVVVVVVVVRPPPPPPPPPPPP
VVVVVVBVVVVVRVVVVVVVVVVVV
VVVPPPPVVVVVRVVVVVVVVVVVV
MVVVVVVVVVVVRVVVVVVVVVVVV
PPPPPPPPPPPPPPVVVVVVVVVVV
VVVVVVVVVVVVVVVVVVVVVVVVV
VVVVVVVVVVVVVVVVVVVVVVVVV
VVVVVVVVVVVVVVVVVVVVVVVVV
MVVVVVVRNVVVVVRVVVVVVVVVV
MVVVVVVRPPPPVPRVVVVVVVVVV
MSVVBVVRVPVVRVRVVVVVVVPVV
MMMMMMMMMMMMMMMMMMMMMMMMM
MMMMMMMMMMMMMMMMMMMMMMMMM
MMMMMMMMMMMMMMMMMMMMMMMMM