25 25
VVVVVVVVVVVVVVVVVVVVVVVVV
VVVVVVVVVVVVVVVVVVVVVVVVV
VVVHVVVVVVVVVVVVVVVVVVVVV
VVVVVVVVVVVVVVVVVVVVVVVVV
VVPPPPPVCVVVVVVVVVVVVVVVV
VVVVVVVVCVVVVVVVRVVVVRVVV
VVVVVVVVCVVVVVVVRVVVVRVVV
VVVPPPPPPPVVVVVVRVVVVRVVV
VVVVVVVVVVPPPPPPRVVVVRVVV
VVVVVVVVVVVVVVVVRVVVVRVVV
VVVVVVVVVVVVRVVVBVVVVRVVV
PPPVVVVVVVVVRPPPPPVVVVVVV
VVVVVVBVVVVVRVVVVVVVVVVVV
VVVPPPPVVVVVRVVVVVVVVVVVV
VVVVVVVVVVVVRVVVVVVVVVVVV
VVVVVVVVPPPPPPVVVVVVVVVVV
VVVVVVVVVVVVVVVVVVVVVVVVV
VVVVVVVVVVVVVVVVVVVVVVVVV
VVVVVVVVVVVVVVVVVVVVVVVVV
VVVVVVVVVVVVVVVVVVVVVVVVV
VVVVVVVVVVVVVVVVVVVVVVVVV
VVVVVVVVVVVVVVVVVVVVVVPVV
MMMMMMMMMMMMMMMMMMMMMMMMM
MMMMMMMMMMMMMMMMMMMMMMMMM
MMMMMMMMMMMMMMMMMMMMMMMMM